20 20
0 0  0 0  0 1  0 1  0 1  0 1  0 1  0 1  0 1  0 1  0 1  0 1  0 1  0 1  0 1  0 1  0 1  0 1  0 0  0 0
0 0  0 1  0 1  0 1  0 1  0 1  0 1  0 1  6 1  5 0  5 0  5 0  5 0  4 0  4 0  0 1  0 1  0 1  0 0  0 0
0 0  0 1  5 0  5 0  5 0  5 0  0 1  0 1  6 1  5 0  5 0  6 1  5 0  4 0  4 0  0 1  0 1  0 1  0 0  0 0
0 0  0 1  5 0  5 0  5 0  5 0  0 1  0 1  6 1  5 0  5 0  5 0  5 0  5 0  5 0  5 0  5 0  0 1  0 0  0 0
0 0  0 1  5 0  5 0  5 0  5 0  0 1  0 1  6 1  5 0  6 1  5 0  5 0  5 0  5 0  6 1  5 0  0 1  0 0  0 0
0 0  0 1  5 0  5 0  5 0  5 0  0 1  0 1  6 1  5 0  5 0  5 0  5 0  5 0  5 0  5 0  5 0  0 1  0 0  0 0
0 0  0 1  5 0  5 0  5 0  5 0  5 0  5 0  6 1  5 0  5 0  5 0  5 0  5 0  5 0  5 0  5 0  0 1  0 0  0 0
0 0  0 1  5 0  5 0  5 0  5 0  5 0  5 0  6 1  5 0  5 0  5 0  5 0  5 0  5 0  5 0  5 0  0 1  0 0  0 0
0 0  0 1  5 0  5 0  6 1  5 0  5 0  5 0  6 1  5 0  5 0  5 0  5 0  5 0  5 0  5 0  5 0  0 1  0 0  0 0
0 0  0 1  5 0  5 0  5 0  5 0  5 0  5 0  6 1  5 0  5 0  5 0  5 0  5 0  6 1  5 0  5 0  0 1  0 0  0 0
0 0  0 1  5 0  5 0  5 0  5 0  5 0  5 0  6 1  5 0  5 0  5 0  5 0  5 0  5 0  5 0  5 0  0 1  0 0  0 0
0 0  0 1  6 1  6 1  6 1  5 0  5 0  5 0  6 1  5 0  5 0  5 0  5 0  5 0  5 0  5 0  5 0  0 1  0 0  0 0
0 0  0 1  5 0  5 0  5 0  5 0  5 0  5 0  6 1  5 0  5 0  5 0  5 0  5 0  5 0  5 0  5 0  0 1  0 0  0 0
0 0  0 1  5 0  5 0  5 0  5 0  5 0  5 0  6 1  5 0  5 0  5 0  5 0  5 0  5 0  5 0  5 0  0 1  0 0  0 0
0 0  0 1  5 0  6 1  5 0  5 0  5 0  5 0  6 1  5 0  5 0  5 0  5 0  5 0  5 0  5 0  5 0  0 1  0 0  0 0
0 0  0 1  5 0  5 0  5 0  5 0  5 0  6 1  6 1  5 0  5 0  5 0  5 0  5 0  5 0  5 0  6 1  0 1  0 0  0 0
0 0  0 1  5 0  5 0  5 0  5 0  5 0  5 0  6 1  5 0  5 0  5 0  5 0  5 0  5 0  5 0  5 0  0 1  0 0  0 0
0 0  0 1  5 0  5 0  5 0  5 0  5 0  5 0  5 0  5 0  5 0  5 0  5 0  5 0  5 0  5 0  5 0  0 1  0 0  0 0
0 0  0 1  5 0  5 0  5 0  5 0  5 0  5 0  5 0  5 0  5 0  5 0  5 0  5 0  5 0  5 0  5 0  0 1  0 0  0 0
0 0  0 0  0 1  0 1  0 1  0 1  0 1  0 1  0 1  0 1  0 1  0 1  0 1  0 1  0 1  0 1  0 1  0 1  0 0  0 0
Map_two
